# This puzzle is unsolvable
10
 55  17  89  78  38  14   7   8  93  41
  0  73  36  79  88  34  46  16  20  44
 57  84  72  99  96  64   2  74  11  66
 67  71  60  15  61  40   9   6  69  45
 87  65  94  59  13  68  12  10  42  58
 97  33  70  83  21  86  43  27  50  53
  1  18  37  35  29  63  26   3  80  92
 39  24  62  19  47   5  56  90  23  51
 95  28  82  54  25  49  76   4  81  52
 32  98  30  48  75  77  22  31  91  85
