# This puzzle is unsolvable
10
 60   1  66  69  58  56  35   5  12  75
 36  82   3  40  43  39  61  96  44  10
 89  38  37  54  91  19  70   7  87  84
 21  28  65  17  30  68  23  11  92  14
 27  29  78  34  67   9  95  85  72  50
 59  62  64  83  22  49  41  51  45  42
 97  81  88  33   6   2  80  74  48   0
 93  71   8  25  57  76  63  77  20  15
 26  98  46  86  24  52   4  47  16  13
 31  99  79  94  90  18  32  55  53  73
