# This puzzle is unsolvable
10
 92   3  85  35  69  11  13  38  44  49
 95  39  36  59  80  72   1   7  21  88
  2  46   6  15  67  12  56   9  40  68
 30  32  86  89  61  99  42  78  47   5
 93  33  45  26  14  23  60  76  10  65
  4  62  64  51  54  94  28  18   8  37
 29  87  58  31  41  83  43  25  50  77
 48  66  90  24   0  55  98  17  19  53
 97  74  84  96  91  75  81  52  79  70
 82  63  57  22  20  16  71  27  73  34
