# This puzzle is unsolvable
10
 40  71  98  36  65  47   9  39  66   4
 16  85  28   3   2  92  11   5  55  99
 62   8  91  89  73  67  69  44   7  14
 33   1  81  86  43  94   6  82  70  72
 32  37  59  26  15  56  97  10  68  50
 77  41  64  74  30  90  18  23  87  52
 38  78  84  35  46  95  61  76  93  60
 24  20  75  83  13  51  79  49  88  96
 34  27  31  58  63  19  17  53  42  21
 29  54  48  45  12  57  80  25   0  22
